wwwwwwwwwwwwwwwwwwwwww
wP...................w
w....................w
w....................w
w...www........www...w
w....................w
w....................w
w.......wwwwww.......w
w....................w
w....................w
w....................w
w....................w
w....................w
w....................w
wwwwwwwwwwwwwwwwwwwwww